111111
100101
10 001
1100S1
1111111111
