111111
100101
10 001
1100N1
1111111111
