        111111111111111111111111111111111111
        100000000000000000000000000000000001
        100000000000000000000000000000000001
        100000011111111111100000000000000001
11111111100000000010000000000000000111111111
1E0000000000000001100000000000000001111111111111111
100000000000000000000000000000000000000000000000001
100000000000011111100000000000000000000000000000001
100000000000000000100000000000000000000000000000001
100000000000000000100000000000000000000000000000001
100000000000000000000001111111000001111111111111111
100000000110000000000000000000000001
100000000000000000000000000001000001
100000000000000000000000000001000001
100000000000000000000000000001000001
11111111111111111001111111111111111
        111111111001111111111111111111111111
        100000000000000000000000000000000001
        100000000000000000000000000000000001
        100000011111111111100000000000000001
11111111100000000010000000000000000111111111
100000000000000001100000000000000001111111111111111
100000000000000000000000000000000000000000000000001
100000000000011111100000000000000000000000000000001
100000000000000000100000000000000000000000000000001
100000000000000000100000000000000000000000000000001
100000000000000000000001111111000001111111111111111
100000000110000000000000000000000001
100000000000000000000000000001000001
100000000000000000000000000001000001
100000000000000000000000000001000001
111111111111111111111111111111111111
