NO ./textures/north.xpm
SO ./textures/south.xpm

C 225,30,0
F 225,30,0
EA ./main.c
WE ./textures/west.xpm

1111111111111111111111111111111111111111111111111
10000000000000000000000000        
1000000000000000000000000000000000000000000000001
1000000001100000000000111111111111111111111111111
1000000001000000011000000000000000000000000000001
1000000001000000011000000000000000000000000000001
1000000001111111111000000000000000000000000000001
1000000000000000000000000000000000000000000000001
1000000000000000000000000000000000000000000000001
111111111110000000000000000000000000000111111111
1000000000000000000000000000000000000000000000001
1000000000000000000000000000000000000000000000001
1000000011111111111111111111000000000000000000001
1000000010000000000000000011000000000000000000001
1000000010000000000000000011000000000000000000001
1000000011111111111111111111000000000000000000001
1000000000000000000000000000000000000000000000001
1000000000000000000000000000000000000000000000001
1111100000000000000000000000000000111111111111111
1000000000000000000000000000000000000000000000001
1000000000000000000000N00000000000000000000000001
1000000001111111111000000000000000000000000000001
1000000001000000011000000000000000000000000000001
1000000001000000011000000000000000000000000000001
1000000001111111111000000000000000000000000000001
1000000000000000000000000000000000000000000000001
1000000000000000000000000000000000000000000000001
1111111111111111111111111000000000000000000111111
1000000000000000000000000000000000000000000000001
1000000000000000000000000000000000000000000000001
1000000000000000000000000000000000000000000000001
1111111111111111111111111111111111111111111111111

