F 18,255,38

C 38,255,18

NO ./textures/north.xpm
EA ./textures/east.xpm
SO ./textures/south.xpm
WE ./textures/west.xpm

        111111111111111111111111111111111111                                                                                                                         
              000N0000                           
             111111111111111111111111111111111111
