F 18,255,38

NO ./textures/north.xpm
EA ./textures/east.xpm

C 80,40,96

SO ./textures/south.xpm
WE ./textures/west.xpm

        111111111111111111111111111111111
        100000000000000000000000000000001
        101111111111111111111111111111101
        100000000000000000000000000000001
        101111101111111111111111101111101
10000010100000000000000101000000111111111
101111101011111111111101011111101
100000001010000000000001010000001
101111111010111111111101011111101
100000000010100000000001010000001
101111111110101111111101011111101
100000000000101000000001010000001
100000101000000000000001010000001  11
    101111101011111111111101011111101
    100000001010000000000001010000001
    101111111010111111111101011111101
    100000000010100000000001010000001
    101111111110101111111101011111101
    100000000000101000000001010000001
    101111111111101011111101011111101
    1000000000000010000000010000000N1
    111111111111111111111111111111111







