F 18,255,38


NO ./textures/north.xpm
EA ./textures/east.xpm
SO ./textures/south.xpm
WE ./textures/west.xpm

C 38,25,150





111111111111111111111111111111111
100000000000000000000000000000001
101111111111111111111111111111101
101000000000000000000000000000101
101011111111111111111111111110101
101010000000000000000000000010101
101010111111111111111111111010101
101010100000000000000000001010101
101010101111111111111111101010101
101010101000000000000001001010101
101010101011111111111101101010101
101010101010000000000101001010101
101010101010111111000101101010101
101010101010100000010101001010101
10101010101010S000010101101010101
101010101010111111110101001010101
101000000000000000000000000000101
101111111111111111111111111111101
100000000000000000000000000000001
111111111111111111111111111111111

