11111111111111111111111111111111111111111111111111
1E00000000000000000000000000000000000000000000001
1000000000000000000000000000000000000000000000001
1000000001111111111000000000000000000000000000001
1000000001000000011000000000000000000000000000001
1000000001000000011000000000000000000000000000001
1000000001111111111000000000000000000000000000001
1000000000000000000000000000000000000000000000001
1000000000000000000000000000000000000000000000001
1111111111100000000000000000000000000000111111111
1000000000000000000000000000000000000000000000001
1000000000000000000000000000000000000000000000001
1000000011111111111111111111000000000000000000001
1000000010000000000000000011000000000000000000001
1000000010000000000000000011000000000000000000001
1000000011111111111111111111000000000000000000001
1000000000000000000000000000000000000000000000001
1000000000000000000000000000000000000000000000001
1111100000000000000000000000000000111111111111111
1000000000000000000000000000000000000000000000001
1000000000000000000000000000000000000000000000001
1000000001111111111000000000000000000000000000001
1000000001000000011000000000000000000000000000001
1000000001000000011000000000000000000000000000001
1000000001111111111000000000000000000000000000001
1000000000000000000000000000000000000000000000001
1000000000000000000000000000000000000000000000001
1111111111111111111111111000000000000000000111111
1000000000000000000000000000000000000000000000001
1000000000000000000000000000000000000000000000001
1000000000000000000000000000000000000000000000001
1111111111111111111111111111111111111111111111111
